Titulo=Descuentos - Extracontractuales

lblFiltrarPor=Filtrar Por:
lblDetalleActivity=Detalle de activity
lblActivityId=Activity ID
lblNombre=Nombre
lblTipoActividad=Tipo Actividad
lblCanal=Canal
lblCentroCostos=Centro Costos
lblVigencia=Vigencia
lblEvidenciaActivity=Evidencia Activity
lblMarca=Marca
lblSubcuenta=Subcuenta
lblEstrategia=Estrategia
lblCuentaContable=Cuenta Contable
lblMontoDescuetoNC=Monto de descuentos autorizado vía NC
lblNotaCreditoQad=Notas de crédito en QAD
lblNotaCreditoAutorizacion=Notas de crédito en autorización
lblBalance=Balance
lblImpactoA=Impacto a
lblSellIn=Sell In
lblSellOut=Sell Out/Otros
lblAplicaIva=Aplica IVA General
lblInactivo=Inactivo
lblSi=Si
lblNo=No
lblNotasCredito=Notas de Crédito
lblEstatus=Estatus
lblSelect=Selecciona una opción
lblEvidencia=Evidencia
lblAll=Todos

gvDescuento-ActivityId=Activity
gvDescuento-Nombre=Nombre
gvDescuento-NombreTipoActividad=Tipo
gvDescuento-Marcas=Marca
gvDescuento-NombreCanal=Canal
gvDescuento-Vigencia=Vigencia
gvDescuento-ValorActivity=Valor Activity
gvDescuento-MontoAutorizacion=Monto en Autorización
gvDescuento-MontoAutorizado=Monto Autorizado
gvDescuento-MontoSolicitado=Monto Solicitado
gvDescuento-MontoQad=Registrado en QAD
gvDescuento-Balance=Balance
gvDescuento-NombreEstatusDescuento=Estatus

gvDescuento-Folio=Folio
gvDescuento-CobrarA=Cobrar A
gvDescuento-Justificacion=Justificación
gvDescuento-Fecha=Fecha
gvDescuento-Subtotal=Subtotal
gvDescuento-Monto=Monto
gvDescuento-NombreSolicitante=Solicitada Por
gvDescuento-QAD=QAD
gvDescuento-Estatus=Estatus

btnAvanzado=Avanzado
btnBuscar=Buscar
btnAgregar=Agregar
btnExcel=Excel
btnVer=Ver

maxFileSize=20
msgArchivoNoEncontrado=No se encontro el archivo.
msgImpractoRequerido=Debe seleccionar una opción de impacto.	
msgAlertGuardar =El descuento ha sido guardado correctamente.

folderArchivos=DescExtracontractual
validExtensions=xlx,xlsx

efdb-Descuento-01=El Activity ID ya existe.