Titulo=Reporte - Arquitectura de clientes
lblFiltrarPor=Filtrar por:
lblNombre=Nombre
lblCanal=Canal
lblRegion=Región
lblVendedor=Vendedor
lblJefeVentas=Jefe Ventas
lblJac=JAC
lblTipo=Tipo (cobrar-a/punto de entrega)
lblAnalista=Analista
lblCobrarA=Cobrar-A
lblPuntoEntrega=Punto de Entrega
lblTodos=Todos

gvReporte-Codigo=Código
gvReporte-CobrA=Cobrar A
gvReporte-NombreCliente=Nombre
gvReporte-Direccion=Dirección
gvReporte-Ciudad=Ciudad
gvReporte-CodigoPostal=CP
gvReporte-Estado=Estado
gvReporte-Pais=País
gvReporte-Rfc=RFC
gvReporte-Canal=Canal
gvReporte-Almacen=Almacén
gvReporte-Tipo=Tipo
gvReporte-Vendedor=Vendedor
gvReporte-JefeVentas=Jefe ventas
gvReporte-AnalistaCartera=Analista de Cartera
gvReporte-Jac=JAC
gvReporte-NombreRegion=Región
gvReporte-Activo=Activo
gvReporte-RetencionCredito=Retención de Credito
gvReporte-NoIdentificador=DV (Digito verificador)
gvReporte-TerminosCredito=Términos de Crédito
gvReporte-ListaPrecios=Lista de Precios
gvReporte-LimiteCredito=Límite de crédito
gvReporte-MontoCartera=Monto Cartera
gvReporte-MontoDisponible=Monto disponible
gvReporte-CuentaLmClientes=Perfil Cliente
gvReporte-Moneda=Moneda
gvReporte-Observaciones=Observaciones

btnAvanzado=Avanzado
btnActualizar=Actualizar
btnExcel=Excel