lblYear = Año
lblSelect = Seleccionar
lblMarca = Marca
lblConcepto = Concepto
lblCuenta=Cuenta
lblUltimaAprobacionDg = Última aprobación DG
lblProyeccionTM = Proyección TM
lblRealEjecutado = Real Ejecutado
lblModificacion = Adición/Recorte Activity
lblGastoFuturo = Gastos Futuros
lblNombreCuenta=Nombre Cuenta
lblDescripcion=Descripción de Registro
lblTotal=Total
lblFecha=Fecha
btnControlTM = Resumen TM
btnSeguimientoAct = Seguimiento Activities Publicados
btnDetalleRealEjecutado=Detalle Real Ejecutado
lblMes1 = Enero
lblMes2 = Febrero
lblMes3 = Marzo
lblMes4 = Abril
lblMes5 = Mayo
lblMes6 = Junio
lblMes7 = Julio
lblMes8 = Agosto
lblMes9 = Septiembre
lblMes10 = Octubre 
lblMes11 = Noviembre
lblMes12 = Diciembre

btnResumenSeg = Resumen
btnDetalleSeg = Detalle
msgGridSinInformacion= No se encontró información para mostrar. 
lblCodigoActividad=Código Activity
lblDescripcionActivity=Descripción Activity
lblActivity=Activity
lblCanal=Canal
lblCuentaNombre=Cuenta Nombre
lblEstatus=Estatus
lblMes=Mes
lblSaldoInicial=Saldo Inicial
lblModificacion1= Adición
lblModificacion2= Recorte
lblTotalActivity=Total Activity
lblTotalEjecutado=Total Ejecutado
lblSaldoActivity=Saldo Activity
lblRubro=Rubro
lblPresupuestado=Presupuestado
lblEjecutado=Ejecutado
btnAvanzado=Avanzado
btnActualizar=Actualizar
btnExcel=Excel
gvRealEjecutado-Marca=Marca
gvRealEjecutado-Cuenta=Cuenta
gvRealEjecutado-CuentaContable=Nombre Cuenta
gvRealEjecutado-Descripcion=Descripción de Registro
gvRealEjecutado-Enero=Enero
gvRealEjecutado-Febrero=Febrero
gvRealEjecutado-Marzo=Marzo
gvRealEjecutado-Abril=Abril
gvRealEjecutado-Mayo=Mayo
gvRealEjecutado-Junio=Junio
gvRealEjecutado-Julio=Julio
gvRealEjecutado-Agosto=Agosto
gvRealEjecutado-Septiembre=Septiembre
gvRealEjecutado-Octubre=Octubre
gvRealEjecutado-Noviembre=Noviembre
gvRealEjecutado-Diciembre=Diciembre
gvRealEjecutado-Total=Total

btnActProNCancel = Activities En Proceso / Cancelados
lblImporte = Importe