Titulo=Requisiciones
lblRequisiciones=Requisiciones
lblTituloModalLanguage=Requisición
lblTituloModalLanguage2=DISTRIBUCIÓN POR SUCURSAL
lblTituloModalLanguage3=COMENTARIOS LISTA NEGRA
lblTituloModalLanguage4=RESUMEN PEDIDO POR SUCURSALES
lblTituloModalLanguage5=Compilado de Requisiciones
lblSubTitulo1=Datos Generales
lblSubTitulo2=Productos
lblSubTitulo3=Proveedores Sugeridos
lblSubTitulo4=Autorizaciones
lblPageDescription=(Common Material Group), es el agrupador de las categorías de materiales utilizado de manera global
lblExport=Exportar
lblNombreAnexo=Layout
lblNuevo=Agregar
lblRequisicionID=ID 
lblRequisicion=Requisicion
lblFecha=Fecha
lblTipoCompra=Tipo Compra
lblSucursal=Sucursal
lblSucursales=Sucursales
lblAlmacen=Almacen
lblSelect=Seleccionar
lblEstatus=Estatus
lblSolicitante=Solicitante
lblJefeInmediato=Jefe Inmediato
lblRazonSocial=Razon Social 
lblDescripcionRequerimiento=Descripción Requerimiento
lblFolio=Folio
lblClasificacion=Clasificación Contable
lblDepartamento=Departamento
lblNumEconomico=No. Economico
lblEmpresa=Empresa
lblAll=Todos
lblAllF=Todas
lblSelectAll=Selec. Todos
lblDeselectAll=Deselec. Todos
lblSelectAllF=Seleccionar Todas
lblDeselectAllF=Deseleccionar Todas
lblActive=Activo
lblListaNegra=Lista Negra
lblInactive=Inactivo
lblMisRequisiciones=Mis Requisiciones
lblPorCotizar=Por Cotizar
lblPorConvertirAOC=Por convertir a OC
lblPorAutorizar=Por Autorizar
lblAnexar=Anexar
lblOtro=Otro
lblRegresarListado=Regresar a Listado
lblIngresarProducto=Ingresar Producto
lblIngresarProveedor=Ingresar Proveedor
lblCapturarProveedor = Ingresar nuevo proveedor
lblIngresarNuevoProveedor=Para Nuevo Proveedor ingrese la palabra Nuevo Proveedor 
lblNuevoProveedor=Nuevo Proveedor
gvRequisicion-Folio=Folio
gvRequisicion-Fecha=Fecha
gvRequisicion-Sucursal=Sucursal
gvRequisicion-TipoCompra=Tipo Compra
gvRequisicion-Estatus=Estatus
efdb-Requisicion-01=No se pueden solicitar más de 3 requisiciones al mismo No Económico durante el mes
efdb-Requisicion-02=No existe un Jefe Inmediato para autorizar esta requisición
efdb-Requisicion-03=No existe un Autorizador de Monto autorizar esta requisición
btnBuscar=Buscar
btnCancel=Cancelar
btnSave=Guardar
btnSolicitar=Solicitar
btnAutorizar=Autorizar
btnRegresar=Regresar
btnRechazar=Rechazar
btnConvertirOC=Convertir OC
btnEnviarAutorizacion=Enviar Autorización
btnEdit=Editar
btnVer=Ver
btnConfigurar=Configurar
btnDelete=Eliminar
msgConfirmdelete=¿Está seguro que desea inactivar el registro? 
msgConfirminactive=Existen registros inactivos, ¿Desea continuar? 
msgConfirmcancel=¿Está seguro que desea salir?. No se guardará ningún cambio
msgConfirmcancelada=¿Está seguro que desea Cancelar la Requisición. Una vez cancelada ya no se podrá recuperar la requisición?
msgConfirminactiveBanco=Existen registros inactivos de Banco, ¿Desea continuar? 
TamanioInvalido=5
msgTamanioInvalido=El archivo deber ser menor a 5 MB
msgArchivoInvalido=El archivo no es válido
ExtensionesValidas=jpg,jpeg,png,pdf,docx,xls,xlsx,pptx
msgExtensionesValidas=El archivo debe de tener alguna de las siguientes extensiones: jpg, jpeg, png, pdf, docx, xls, xlsx, pptx
TamanioMaximoArchivos=1
msgDeleteFile=¿Está seguro de eliminar el archivo?
lblFindFile=Buscar Archivo
gvProducto-Producto=Producto
gvProducto-Cantidad=Cantidad
gvProducto-Descripcion=Descripción del Producto
gvProducto-Precio-Est=Precio Estimado
gvProducto-Precio=Precio
gvProducto-Moneda=Moneda
gvProducto-Anexo=Anexo
gvProductoInventario-Producto=Producto
gvProductoInventario-Cantidad=Cantidad
gvProductoInventario-PrecioUnitario=Precio Unitario
gvProductoInventario-Precio=Precio
gvProductoInventario-Moneda=Moneda
gvProductoInventario-UnidadMedida=Unidad de Medida
gvProductoInventario-Proveedor=Proveedor
gvProductoInventario-OC=OC
efdb-RequisicionProducto-01=El Producto que intenta Guardar ya se encuentra dada de Alta
efdb-RequisicionProducto-02=No se pueden realizar requisiciones del mismo producto de la sucursal el mismo día
msgConfirminactiveProducto=Existen registros inactivos de Productos, ¿Desea continuar? 
gvProveedor-NombreProveedor=Proveedor
gvProveedor-Cotizaciones=Cotizaciones
gvProveedor-Precio=Precio
gvProveedor-Moneda=Moneda
gvProveedor-Ganador=Ganador
efdb-RequisicionProveedor-01=El Proveedor que intenta Guardar ya se encuentra dada de Alta
efdb-RequisicionProveedor-02=No se pueden hacer requisiciones al mismo proveedor el mismo día / sucursal
msgConfirminactiveProveedor=Existen registros inactivos de Proveedor, ¿Desea continuar? 
msgFiltroFechaInicial=Fecha Inicial es requerida
msgFiltroFechaFinal=Fecha Final es requerida
msjDistribuirSinProducto= Favor de seleccionar un producto válido para realizar la distribución.
msjDistribuirSinCantidad = Favor de capturar una cantidad válida para realizar la distribución.
msjDistribuirEnCero = Debe distribuir el total de la cantidad a ordenar entre las sucursales.
gvAlmacen-NombreAlmacen=Sucursal
gvAlmacen-Inventario=Inventario
gvAlmacen-Cantidad=Cantidad a ordenar
lblDistribucionSucursal = Distribución por sucursal
lblDistribuir=Distribuir
lblVer=Ver
lblVerResumen=Ver Resumen
lblPorDistribuir=Por Distribuir
lblNombreProducto=Producto
lblTipoConsumo=Tipo Consumo
lblCantidad=Cantidad
msgAlmacenError=Debe distribuir el total de la cantidad a ordenar entre las sucursales
gvAutorizacion-NombrePerfil=Rol
gvAutorizacion-FechaAutorizacion=Fecha
gvAutorizacion-NombreUsuario=Nombre
msgAlertGuardar = La requisición ha sido guardada con éxito.
msgAlertSolicitar = La requisición ha sido solicitada con éxito.
msgAlertAutorizada = La requisición ha sido autorizada con éxito.
msgAlertRechazada = La requisición ha sido rechazada con éxito.
msgAlertCancelada = La requisición ha sido cancelada con éxito.
msgAlertAutorizacionMonto = La requisición ha sido enviada para autorizar con éxito.
msgConfirmAutorizar=¿Seguro que desea Autorizar la Requisición?
msgConfirmRechazar=¿Seguro que desea Rechazar la Requisición?
msgConfirmSolicitar=¿Seguro que desea realizar la Solicitud de la Requisición?
msgConfirmSolicitarOrdenCompra=¿Seguro que desea Solicitar la Orden de Compra?
msgConfirmEnviarAutorizacion=¿Seguro que desea Enviar la Autorización?
msgConfirmCambiarTipoCompra=Al cambiar el Tipo de Compra se reinicializarán los Productos, ¿Desea continuar?
msgConfirmEnviarAutorizar = ¿Seguro que desea enviar la requisición para autorización?
msgConfirmCOnvertirOC = ¿Seguro que desea convertir la requisición en orden de compra?
msgEnviada=La Requisición ha sido enviada con éxito
msgErrorGanador=Debe seleccionar un Proveedor Ganador
msgErrorProductoCantidad=Debe especificar la Cantidad del Producto
msgErrorProducto=Debe especificar al menos un Producto
msgErrorDescripcion=La Descripción de la Requisición es requerida
msgErrorProductoDistribucion=Debe distribuir todas las cantidades de los Productos
msgErrorProveedor=Debe sugerir al menos un Proveedor
msgErrorNumEconomico=Debe especificar el Número Económico para la requisición
msgErrorTipoCompra=Debe especificar el Tipo Compra para agregar el producto
msgErrorProductoInventario=No existe Inventario para el Almacen configurado
msgErrorProductoInventarioCompra=Debe seleccionar al menos un Producto para Solicitar
lblProveedor=Proveedor
lblEntregarEn=Entregar En
lblPagoParcial=Pagos Parciales (Abierta)
lblVigenciaOC=Vigencia OC
lblSubtotal=Subtotal
lblIVA=IVA
lblIVARetenido=IVA Retenido
lblISRRetenido=ISR Retenido
lblTotal=Total
efdb-OrdenCompra-01=Fecha Final Vigencia no puede ser menor a la Inicial
lblDatosGenerales = Datos Generales
lblProductos = Productos 
lblProducto = Producto
lblAUtorizaciones = Autorizaciones
lblProveedores = Proveedores
efdb-Requisicion-Autorizador-00 = Favor de verificar los precios de productos, alguno no cumple con el valor mínimo requerido.
efdb-Requisicion-Autorizador-01 = Favor de verificar la información requerida.
efdb-Requisicion-Autorizador-02 = Favor de registrar el proveedor en el catálogo, actualmente solo esta registrado como sugerido.
efdb-Requisicion-Autorizador-03 = No existe un autorizador en base a la estructura del Solicitante, Favor de Verificar.
efdb-Requisicion-Autorizador-04 = Favor de verificar los precios de proveedores, el monto debe ser mayor a 0.