Titulo=Usuarios  
lblFiltrarPor=Filtrar por:
NombreUsuario=Nombre
Contrasenia=Contraseña
NumUsuario=Número de usuario
Usuario=Usuario 
Perfil=Perfil
Correo=Correo
RecibeNotificaciones=Recibe Notificaciones
Active=Activo
IdAnalista= ID Analista
FechaUltimoAcceso=Ultimo Acceso
PerfilFuncional=Perfil Funcional
Vendedor=Vendedor
lblNuevo=Agregar
btnVer=Ver
msgAlertGuardar = El Usuario ha sido guardado correctamente.
lblSelect=Selecciona una opción
msgGridSinInformacion=No se encontró información para mostrar.
TituloDetalle=Detalle
BuscarNombreVendedor= Buscar usuario.
CambiarContrasena=Cambiar Contraseña
Imagen=Imagen
Password=Password
NuevoPassword= Nuevo Password
ConfirmarNuevoPassword=Confirmar Nuevo Password
InformacionGeneral=Información General
CambiarImagen=Cambiar Imagen
Actualizar=Actualizar
msgInvalidExtensionFile=La extension del archivo no es valido.
Agregar=Agregar
Area=Area
AutorizadorActivity=Autorizador de Activity
AutorizadorModificacion=Autorizador Modificacion
LiderProceso=Lider Proceso
Rubro=Rubro
Tareas=Tareas
efdb-Usuario-01 =El usuario ya existe
efdb-Usuario-02=La contraseña no puede ir vacia
efdb-Usuario-03=Error en el Sal del Usuario
efdb-Usuario-04=El usuario ya existe
efdb-Usuario-05=El Correo ya ha sido utilizado en otro Usuario
lblUsuarioQad = Usuario Qad
lblMarca=Marca
lblCanal=Canal
SeleccionarCanales = Seleccione al menos 1 Marca y 1 Canal