Titulo= Activities - Provisiones
lblFiltrarPor=Filtrar por:
lblBusquedaActivity = Búsqueda Rápida por Activity
gvProvision-Mes= Mes
gvProvision-Provision=Provisión
gvProvision-Estatus=Estatus
gvProvision-NombreCuenta=Nombre Cuenta
gvProvision-Cuenta = Cuenta
gvProvision-Subcuenta = Subcuenta
gvProvision-CentroCostos = Centro Costos
gvProvision-Proyecto = Proyecto
gvProvision-Entidad = Entidad
gvProvision-Descripcion = Descripcion
gvProvision-Cargo = Cargo
gvProvision-Abono = Abono



lblTooltipAprobar = Aprobar
lblTooltipRechazar = Rechazar



gvProvision-Year=Año
lblEstatus= Estatus:
Nombre=Canal
Clave=Clave
Canal=Canal
Grupo=Grupo
Recaudo=Recaudo
Porcentaje=Porcentaje
AgregadoDias=Agregado a días de vencimiento
ProyectoQAD=Proyecto QAD
NomenclaturaProyecto=Nomenclatura Proyecto
Gerente=Gerente
GerenteMac=Gerente MAC
CoordinadorMac=Coordinador MAC
CentroCostos=Centro de Costos
CentroCostosLogistica=Centro de Costos Logística
Sufijo=Sufijo
AplicaCobrabilidad=Aplica Cobrabilidad
ObjetivoCobrabilidad=Objetivo Cobrabilidad (%)
lblNuevo=Agregar
btnVer=Ver
msgAlertGuardar = El Canal ha sido guardado correctamente.
lblSelect=Selecciona una opción
msgGridSinInformacion=No se encontró información para mostrar.
efdb-Canal-01=El Canal ya existe.