Titulo=Descuentos - Contractuales
lblFiltrarPor=Filtar por:
Cliente=Cliente
Tipo=Tipo 
Marca=Marca
Canal=Canal
Vigencia=Vigencia
Estatus=Estatus 
Codigo=Código
CodigoCliente=Código Cliente
CuentaContable=Cuenta contable
TipoDescuento=Tipo
Fiscal=Fiscal
lblSi=Si
lblNo=No
lblAplicaIva=Aplica IVA General
lblCentroCostoLogistica=Centro de Costos Logística
lblDiasProntoPago=Dias Pronto Pago
TitleNotasCredito=Notas de crédito
Fecha=Fecha
Monto=Monto/Porcentaje
MontoFijo=Monto Fijo
SolicitadaPor=Solicitada Por
QAD=QAD
EstatusNC=Estatus
lblNuevo=Agregar
btnVer=Ver
msgAlertGuardar = El descuento ha sido guardado correctamente.
lblSelect=Selecciona una opción
msgGridSinInformacion=No se encontró información para mostrar.
TituloDetalle=Detalle
BuscarNombreSolicitud= Buscar Descuento.
TipoDescuentoContractual=Tipo descuento
msgErrorFechaFin=La fecha inicio no puede ser mayor a la fecha fin.
msgErrorPorcentajeMayor= El porcentaje no puede ser mayor a 100.
msgErrorDiasProntoPago= Los días de pronto pago deben ser mayor a 0.
Folio=Folio
MontoNC=Monto
FiltroVigencia=Vigencia

gvDescuento-Codigo=Código
gvDescuento-CodigoCliente=Código Cliente
gvDescuento-Cliente=Cliente
gvDescuento-Canal=Canal
gvDescuento-Tipo=Tipo
gvDescuento-Vigencia=Vigencia
gvDescuento-Estatus=Estatus
gvDescuento-Monto=Monto/Porcentaje

efdb-DescuentoContractual-01=El descuento ya existe para la vigencia seleccionada