Titulo = Activities - Tareas Pendientes
lblFiltrarPor=Filtrar Por:
lblBusqueda = Búsqueda Rápida por Activity
lblActivity = Activity
lblTarea = Tarea
lblFecha = Fecha
lblResponsable = Responsable
lblFechaEjecuto = Fecha Ejecutó
lblEstatus = Estatus
lblAltaQAD = Alta Proyecto en QAD
lblRealizado = Realizado
lblVer = Ver
lblFiltroTareas = Tareas
lblFiltroFecha = Fecha
lblFiltroResponsable = Responsable
lblEsatus = Estatus
lblTituloAltaProyecto = Alta Proyecto en QAD
lblTituloCreacionCodigo = Creación Códigos Promocionales
lblCodigoPromocion = Código Promoción
lblMarca = Marca
lblFechas = Fechas
lblTituloAltaProvision = Alta Provisión
lblPoliza = Poliza
lblActualizarFechaCierre = Actualizar Fecha de Cierre QAD
lblFechaCierreActual = Fecha Cierre Actual
lblNuevaFechaCierre = Nueva Fecha Cierre
lblCierreProyecto = Cierre Proyecto en QAD
lblCierreCodigo = Cierre Código Promocional QAD
lblSelect = Seleccione ...
lblProveedor = Proveedor
lblDescripcion = Descripción
lblCodigoArticulo = Código Artículo
lblProveedorSel = Proveedor
lblPopTable = Pop
lblPromocionTable = Promoción
lblOtrosTable = Otros
lblConcursoTable = Concurso