Titulo=Pre-Notas de Crédito

lblFiltrarPor=Filtrar por:
lblFolio=Folio
lblPendientesAutorizar=Pendientes Autorizar
lblCobrarA=Cobrar a
lblTipo=Tipo 
lblFecha=Fecha
lblSolicitadaPor=Solicitada Por
lblQAD=QAD
lblEstatus=Estatus

lblEvidencias=Evidencias
lblArchivoActual=Archivo Actual
lblRequerido=Requerido
lblCargarEvidencia=Cargar Evidencia
lblDescargarPlantilla=Descargar Plantilla

lblDatosGenerales=DatosGenerales 
lblTipoNC=Tipo NC
lblCliente=Cliente
lblSolicitanteVendedor=Solicitante / Vendedor
lblImpactoA=Tipo Apoyo
lblSellIn=Sell In
lblSellOut=Sell Out/Otros
lblMontoInicial=Monto Inicial
lblMultiplicarPor=Multiplicar por
lblMonto=Monto
lblAplicaIva=Aplica IVA General
lblAplicaIvaRetencion=Aplica Retención de IVA
lblRetencionIVA=Retención de IVA:
lblTotalConRetencionIVA=Total:
lblTipoIva=Tipo de IVA
lblAplicaTipoIvaCentro=Centro
lblAplicaTipoIvaFrontera=Frontera
lblFechaConciliacion=Fecha Conciliación
lblCalculoOriginal=Calculo Original
lblSi=Si
lblNo=No
lblCanal=Canal
lblCuentaContable=Cuenta Contable
lblJustificacion=Justificación
lblActivity=Activity
lblEstrategia=Estrategia
lblPorcentaje=Porcentaje
lblMontoCalculadoNc=Monto calculado para NC
lblMontoAurotizado=Monto de descuentos autorizado vía NC
lblMontoEnAutorizacion=Notas de Crédito
lblBalance=Balance
lblTooltipAprobar=Aprobar
lblTooltipRechazar=Rechazar
lblTooltipEnviar=Enviar
lblTooltipCorreccion=Solicitar Corrección
lblTooltipCancelar=Cancelar
lblTooltipVerDetalle=Ver Detalle
lblTooltipGuardaryEnviar=Guardar y Enviar
lblComentarios=Comentarios
lblComentario=Comentario
lblNombre=Nombre

lblEvidencia=Evidencia
lblDescripcion=Descripción
lblArchivo=Archivo
lblFujoAprobacion=Flujo Aprobación
lblNombreAprobador=Nombre Aprobador
lblPerfilFuncional=Perfil Funcional
lblAprobado=Aprobado

lblValoresAbuscar=Valores a buscar
lblFacturas=Facturas
lblDetalleAplicacion=Detalle de aplicación
lblValorBusqueda=Valor de Búsqueda
lblCodigo=Código
lblFactura=Factura
lblMontoFacturado=Monto facturado
lblMontoAbierto=Monto abierto
lblMontoTotal=MontoTotal

lblJustificacionProntoPago=Justificación Pronto Pago
lblTooltipExcepcionProntoPago=Excepción Pronto Pago
lblFechaRecibo=Fecha Recibo
lblFechaFactura=Fecha Factura
lblFechaPago=Fecha Pago
lblAplicaProntoPago=Pronto Pago

lblGeneralesNc=Generales NC
lblCuentaIva=Cuenta IVA
lblLibroDiario=Libro Diario 
lblOrdenCompra=Orden de Compra
lblDescripcionDetallada=Descripción Detallada

lblCodigoMarca=Código
lblMarca=Marca
lblCantidadUnitaria=Cantidad Unitaria
lblSubtotal=Subtotal
lblIva=Iva
lblTotal=Total
lblAjusteCentavos=Monto con ajuste centavos

lblSelect=Selecciona una opción
TituloDetalle= <b></b>

lblProductos=Productos
lblCodigoProducto=Código Producto
lblProducto=Producto
lblCostoConIva=Precio de Costo con IVA
lblPiezasPorCaja=Piezas por Caja
lblInformacionDevolucion=INFORMACIÓN DE DEVOLUCIÓN
lblEstadoProducto=Estado del Producto a Devolver
lblAveriado=Averiado
lblDisponible=Disponible
lblCausalDevolucion=Causal Devolución
lblCantidadSolicitada=Cantidad Solicitada/Costo
lblCaja=Caja
lblUnidad=Uni
lblCantidadRecibida=Cantidad Recibida
lblMontoDevolucionIva=Monto Devolución con IVA
lblTotalDevolucion=Total Devolución
lblNotaDevolucion=Toda devolución que regrese con menos del 50% de su vida util, debe ser evacuada de forma inmediata por el canal, de acuerdo a la relación en el campo de observaciones
lblDireccion=Dirección Cliente
lblAprobar=Aprobar
lblgenerarCimNc=CIM
lblgenerarCimNcGlobales=Compensación
lblSeleccionarCIM=Selección CIM
lblDetalle=Detalle
lblCerrar=Cerrar

lblDescripcionGeneral=Descripción General
gvNotaCredito-Folio=Folio
gvNotaCredito-CodigoCliente=Código Cobrar a
gvNotaCredito-NombreCliente=Cobrar a
gvNotaCredito-CuentaContable =Cuenta Contable 
gvNotaCredito-NombreTipoNotaCredito=Tipo
gvNotaCredito-Marcas=Marca
gvNotaCredito-NombreCanal=Canal
gvNotaCredito-TipoActivity=Tipo/Activity
gvNotaCredito-Justificacion=Justificación
gvNotaCredito-Fecha=Fecha de Solicitud
gvNotaCredito-FechaAprobacion=Fecha de Aprobacion
gvNotaCredito-Subtotal=Subtotal
gvNotaCredito-Monto=Monto
gvNotaCredito-NombreSolicitante=Solicitada Por
gvNotaCredito-NombreAprobador=Pendiente de Autorizar por
gvNotaCredito-QAD=QAD
gvNotaCredito-Estatus=Estatus
gvNotaCredito-TieneAjuste=Tiene Ajuste
gvNotaCredito-MontoAjuste=Monto Ajuste

btnAvanzado=Avanzado
btnBuscar=Buscar
btnAgregar=Agregar
btnExcel=Excel
btnVer=Ver
btnGuardar=Guardar
btnAnexar=Anexar
btnCerrar=Cerrar

mensajeBusqueda=Escriba o pegue palabras clave a buscar en factura, valores separados por espacio, coma o punto y coma.
msgAlertGuardar = La solicitud ha sido guardada correctamente.
msgGridSinInformacion=No se encontró información para mostrar.
msgErrorFechaFin=La fecha inicio no puede ser mayor a la fecha fin.
msgErrorPorcentajeMayor= El porcentaje no puede ser mayor a 100.
msgArchivoNoEncontrado=No se encontro el archivo.
msgMontoMayorMontoAutoriado=El monto no puede ser mayor al monto de descuento autorizado.
msgSeleccioanarFactura=Debe seleccionar por lo menos una factura.
msgAgregarSoporte=Debe adjuntar evidencia.
msgAgregarSoporteProntoPago=Debe capturar justificación del Pronto Pago.
msgAbrirEvidencia=Antes de aprobar o rechazar debe revisar la evidencia.
msgConfirmarAprobar=Se aprobará la solicitud, ¿Desea continuar?
msgConfirmarRechazar=Se rechazará la solicitud, ¿Desea continuar?
msgConfirmarCancelar=Se cancelará la solicitud, ¿Desea continuar?
msgConfirmarCorreccion=La solicitud se enviará a corrección, ¿Desea continuar?
msgComentarioRequerdio=Debe agregar un comentario.
msgMotivoNotaRequerdio=El número de Nota generada es requerido.
msgSellIn=Se enviará la solicitud con un monto de {0}. ¿Desea continuar?.
msgAprobarNotas=Se aprobarán {0} solicitudes. ¿Desea continuar?.
msgGenerarCIMNotas=Se generará CIM con {0} solicitudes. ¿Desea continuar?.
msgGenerarCIMNotasNONE=Debe seleccionar al menos una nota para continuar.
msgGenerarCIMNotasClientes=La Notas de Crédito seleccionadas no pertenecen al mismo cliente.
msgSeleccionarTipoActivity=Por favor seleccionar el Tipo de Activity (Sell In o Sell Out).
msgAgregarMarcas=Debe agregar por lo menos una marca.
msgTopeDiasProntoPago=Está intentando sobre pasar el monto tope para los ajustes: 
folderArchivos=NotasCredito

efdb-NotaCreditoFlujo-01=No se puede enviar la solicitud porque alguno de los aprobadores no esta dado de alta. Contactar con el Administrador para solucionar este problema.
efdb-Solicitud-01=El monto no puede ser mayor al monto de descuento autorizado.
efdb-Solicitud-02=Esta soliitud no puede ser modificada
efdb-Solicitud-03=El Descuento Seleccionado tiene un tipo de descuento por Monto, lo cual no es permitido, favor de corregirlo

maxFileSize=20
validExtensions=xlx,xlsx,pdf,doc,docx,png,jpg,jpeg
folderArchivosPlantilla=TipoApoyo
lblDescargar=Descargar


