Titulo=Pagos - Conciliación
TituloDetalle=Detalle de Pago
lblFiltrarPor=Filtrar por:
lblCliente=Cliente
lblClienteCodigo=Cliente Nombre/Código
lblConciliacionesAbiertas=Solo conciliaciones abiertas
lblPuntoEntrega=Punto de Entrega
lblTodos=Todos
lblDocumento=Documento

gvReporte-Cliente=Cliente
gvReporte-CobrarA=Cobr-A
gvReporte-GeneradoPor=Generado Por
gvReporte-Fecha=Fecha
gvReporte-MontoFacturado=Monto Facturado
gvReporte-MontoPagado=Monto Pagado
gvReporte-MontoNc=Monto por NC
gvReporte-MontoPorConciliar=Monto por Conciliar
gvReporte-NombreEstatus=Estatus
gvReporte-GenerarInsumo=Gen. Insumo
gvReporte-DeFactura=De Factura
gvReporte-AFactura=A Factura


lblDatosGenerales=Datos Generales
lblMontoFacturado=Monto Facturado
lblMontoPagado=Monto Pagado
lblPagosPorAplicar=Pagos por aplicar
lblFaltantePago=Faltante pago
lblFaltantePagoNC=Faltante pago / NC
lblSaldoPorGenerarNc=Saldo por generar NC
lblNcPorAplicar=NC por aplicar
lblFaltanteNc=Faltante NC
lblFacturas=Facturas
lblFactura=Factura
lblPagos=Pagos
lblBusquedaFactura=Búsqueda de facturas
lblFecha=Fecha
lblMontoTotal=Monto Total
lblMontoAbierto=Monto Abierto
lblMontoPorAplicar=Monto a Aplicar
lblNotasCredito=Notas de Crédito
lblNotaCredito=Nota de Crédito
lblNotasCreditoAdicionales=Notas de crédito adicionales
lblTipo=Tipo
lblNotaCreditoQad=Nota de crédito QAD
lblMonto=Monto
lblGeneralesNc=Generales NC
lblDescripcionGeneral=Descripción General
lblOrdenCompra=Orden de Compra
lblDescripcionDetallada=Descripción Detallada
lblEsFiscal=Es Fiscal
lblCuentaIva=Cuenta IVA
lblLibroDiario=Libro Diario
lblComentarios=Comentarios
lblBusquedaNc=Búsqueda de notas de crédito
lblMontoSolicitud=MontoSolicitud
lblCerrar=Cerrar
lblTooltipGuardarCerrar=Guardar y Cerrar
lblSelect=Selecciona una opción
lblDetalleCruceNotas=Detalle Cruce de Notas
lblCruceId=ID Cruce
lblMontoAbiertoDespuesPago=Monto abierto después de pago
lblMontoAplicarNcQad=Monto a aplicar NC QAD
lblFechaConciliacion=Fecha de Conciliación
lblTooltipNuevoCruce=Nueva Conciliación
lblBalance=Balance
lblSaldoFactura=Saldo Factura
lblConsecutivo=Consecutivo

btnAvanzado=Avanzado
btnActualizar=Actualizar
btnAgregar=Agregar
btnExcel=Excel
btnVer=Ver
btnDescargar=Descargar
btnGenerarCimNc=Generar CIM Creación de NC´s
btnGenerarCimPagos=Generar CIM Cruce documentos
btnGenerar=Insumo

mensajeBusqueda=Escriba o pegue palabras clave a buscar en factura, valores separados por espacio, coma o punto y coma.
msgDetalleRequerido=Debe agregar por lo menos un Pago o un Nota de Crédito Adicional.
msgMontoPorAplicarIncorrectos=El monto a aplicar no puede ser mayor al monto abierto:
msgMontoCruceIdIncorrecto=El Monto en el detalle de cruce debe ser igual al monto por aplicar de las notas de crédito, ID Cruce incorrecto:
msgCruceNotasIncorrecto=Detalle Cruce de Notas, el monto a aplicar no puede ser mayor al monto abierto:
msgCruceSinPagoIncorrecto=Detalle Cruce de Notas, el monto a aplicar tiene que ser igual al monto abierto:
msgNotasIncompletas=Favor de completar la información de las siguientes Notas de Crédito Adicionales:
msgFaltantePagoInvalido=El Faltante de Pago debe de ser cero.
msgFaltanteNcInvalido=El Balance del cruce no esta en Cero, favor de validar.
msgFaltantePagoInvalidoFinal=De acuerdo a la conciliación del pago se dejara abierto en cartera el documento(s):
msgFacturaDuplicada=Esta factura ya esta seleccionada en otra conciliación.
msgNotaDuplicada=Esta nota ya esta seleccionada en otra conciliación.
msgCargaExitosa=Se generó la cargo con éxito.
msgErrorCarga=No se pudo generar la carga, favor de contactar con el area de sistemas.
msgFechaConciliacionRequerida=La fecha de conciliación es requerida.
msgFechaInvalida=La fecha solo puede ser del mes actual o del mes anterior.
msgFacturaDuplicadaLista=Esta factura está duplicada en la búsqueda.
msgNotaDuplicadaLista=Esta nota  está duplicada en la búsqueda.
msgFacturaUtilizadaLista=Este Pago se usó en otra Conciliación.
msgFacturaUtilizadaListaDos=Este Pago está duplicada en la búsqueda y se usó en otra Conciliación.
msgFacturaNoAnalista=El documento pertenece a un agremiado que no te corresponde.
msgEliminar=¿Desea Eliminar esta Conciliación?
msgGuardado=Movimiento Guardado de forma correcta.
msgErrorCruceId=Falta ingresar ID de Cruce.

gvDescarga-ConciliacionId=ID TPM
gvDescarga-FechaConciliacion=Fecha Conciliacion
gvDescarga-ClienteId=ClienteId
gvDescarga-NombreCliente=Nombre Cliente
gvDescarga-DocumentoId=DocumentoId
gvDescarga-FechaDocumento=Fecha Documento
gvDescarga-Monto=Monto
gvDescarga-MontoPorAplicar=Monto por Aplicar
gvDescarga-MontoAbierto=Monto Abierto
gvDescarga-Comentarios=Comentarios
gvDescarga-FechaPago=Fecha Pago
gvDescarga-FechaRecibo=Fecha Recibo