Titulo = Activities - Captura de Requisiciones
lblNumeroRequisicion = Num. Requisición
lblProveedor = Proveedor
lblNumeroProveedor = Num. Proveedor
lblProveedorTabla = Nombre de Proveedor
lblBusquedaRequisicion = Búsqueda por Num. de Requisición o Activity
lblTooltipGuardar = Guardar
lblRequisicion = Datos de la requisición
lblFechaRequisicion = Fecha Requisición
lblUsuarioFinal = Usuario final
lblSolicitadopor = Solicitado por
lblFechaNecesaria = Fecha Necesaria
lblFechaQueSeRequiere=Fecha que se Requiere
lblFechaEntragaEstimada=Fecha Entrega Estimada
lblFechaVence = Fecha Vence
lblSubCuenta = SubCuenta
lblCeCo = Centro de Costos
lblAlmacen = Almacen
lblProyecto =  Proyecto
lblEmpresa = Empresa
lblMoneda = Moneda
lblIdioma = Idioma
lblFormatoLinea = Formato Linea(U/M)
lblActivity = Activity
lblCosto = Total Costo
lblArticulo = Artículo
lblArticulos = Artículos
lblNumArticulo = Num. Artículo
lblUM = UM
lblCantidad = Cantidad
lblCostoUnitario = Costo Unitario
lblObservaciones = Observaciones
lblSelect = --Seleccionar--
lblGrupoLibro = Grupo Libro
lblComprador = Comprador
lblRutaA = Ruta A
lblRubro = Rubro
lblBusquedaActivity = Búsqueda por Activity
lblBusquedaNumProveedor = Búsqueda por Num. de Proveedor
lblUbicacion = Ubicación
lblTotalCosto = Total costo
lblCantArticulos = Cantidad Artículos
lblFechas = Fechas
lblMontoMax = Monto Máximo
lblMontoMin = Monto Mínimo
lblTotal = Total
lblVerComentario = Ver Observaciones
lblCodigoActivity = Código Activity
lblSinObservaciones = Sin Observaciones
lblAprobador = Aprobador
lblRequisitor = Requisitor
lblCuenta = Cuenta