Titulo=Activities

lblBusquedaFolio=Búsqueda Rápida por (Folio)
lblEstatus=Estatus
lblPendientesAutorizar=Pendientes por Autorizar

gvActivity-Codigo=Activity
gvActivity-Nombre=Nombre
gvActivity-Marca=Marca
gvActivity-Canal=Canal
gvActivity-FechaInicio=Fecha Inicio
gvActivity-FechaFin=Fecha Fin
gvActivity-Fecha=Fecha Inicio – Fecha Final
gvActivity-Importe=Importe
gvActivity-Ejecutado=Ejecutado
gvActivity-Porcentaje=%
gvActivity-Estatus=Estatus

lblMarca=Marca
lblCanal=Canal
lblArea=Área
lblFechas=Fecha Actividad (Inicia – Fin)
lblRubros=Rubros
lblActivities=Activities
lblReactivo=Reactivo
lblImporte=Importe
lblEjecutado=Ejecutado
lblActivity=Activity
lblEvaluacion=Evaluación
lblLog=Log
lblDatosGenerales=Datos Generales 
lblNombre=Nombre
lblCentroCostos=Centro Costos
lblSubcuenta=Subcuenta
lblCierrePresupuestoEvaluación=Cierre Presupuesto / Evaluación
lblEstrategia=Estrategia
lblMotivoFechaInicio = Motivo Fecha Inicio
lblPromocionConfigurada=Promoción Configurada
lblNotaPromocion=Descripción de la Promoción y Ganancia a Cliente.
lblObjetivos=Objetivos
lblResultadosClaveFinales=Resultados Clave Finales
lblIndicadorTotalCanal=Indicador Total Canal
lblUm=UM
lblActual=Actual
lblObjetivo=Objetivo
lblNuevoObjetivo=Nuevo Objetivo
lblNumeroPromociones=No. Promociones
lblHerramientaMedicion=Herramienta de Medición
lblDetalle=Detalle
lblCuentaPuc=Cuenta PUC
lblCodigoPromocion=Cod. Promoción
lblCargarPromocion=Cargar Promoción
lblEmpresa=Empresas
lblTipoMovimiento=Tipo Movimiento
lblAlmacenCanal=Almacén / Canal
lblConfiguracionListaPrecio=Conf. Lista Precio
lblConfiguracionAlmacenes=Conf. Almacenes
lblNumeroElemento=No. Elemento
lblCantidad=Cantidad
lblTipoElemento=Tipo Elemento
lblParticipacionPrecio=% Participación Precio
lblArticulo=Artículo
lblDescripcion=Descripción
lblConfiguracionListaPromocion=Configuración de Lista de Precio para Promoción Configurada
lblCanalAlmacen=Canal / Almacen
lblDescuentoPrecio=Descuento Precio (Promedio)
lblPrecio=Precio
lblNumeroLista=No. Lista
lblPrecioUnidad=Precio Unidad
lblPrecioDisplay=Precio Display
lblPrecioCaja=Precio Caja
lblDescuento=Descuento
lblDescuentoPesos=Descuento Pesos
lblPrecioPromocion=Precio Promoción
lblFechaInicio=Fecha Inicio
lblFechaCierre=Fecha Cierre
lblConfiguracionAlmacen=Configuración de Almacén para Promoción Configurada
lblInformacionAdicionalPromocion=Información Adicional de Promoción
lblLinea=Línea
lblGrupo=Grupo
lblImpuesto=Impuesto
lblAlmacenPrincipal=Almacén Principal
lblTipo=Tipo
lblPlaneador=Planeador
lblCodigoBarras=Código Barras
lblUmaCajaDisplay=UMA DE CJ A DP
lblUmaCajaUnidad=UMA DE CJ A U
lblAll=Todos
lblSelect=Seleccione
lblTipoActividad = Tipo Activity
lblClaseImpuesto = Clase Impuesto
lblIsRefresh=Solo Actualizar
lblCargarEstructuraComercial=Cargar Estructura Comercial
lblCantidadPromociones=Cantidad Promociones
lblJustificacionExtemporanea=Justificación (es Extemporánea)

lblDescuentoNotaCredito=Descuentos vía Notas de Crédito
lblDescripcionNotaCredito=Control de roll back y revalorización de inventarios / remates.
lblCodigoProducto=Código Producto
lblCliente=Cliente
lblPrecioActual=Precio Actual
lblTotalDescuento=Total Descuento
lblTotalPrecio=Total Precio
lblObjetivoCajas=Objetivo 
lblObjetivoPesos=Objetivo ($)

lblConcursos=Concursos
lblNotaConcurso=Control de roll back y revalorización de inventarios / remates.
lblFuerzaVentasQuala=FUERZA DE VENTAS QUALA
lblFuerzaVentasExterna=FUERZA DE VENTAS EXTERNA
lblFolioNomina=Folio Nómina
lblNoAplica=NA
lblCargoQueAplica=Cargo al que Aplica
lblNumeroPersonas=No. Personas
lblNumeroPremios=No. Premios
lblIncentivo=$ Incentivo
lblFechaInicioFin=Fecha Inicio - Fin
lblNotaObjetivoConcurso=BASES Y MECÁNICA DE LIQUIDACIÓN DEL CONCURSO. Describe de forma clara y específica la(s) instrucción(es) para liquidar el concurso. Si requieres, puedes utilizar ejemplos como apoyo a la liquidación
lblFormaPago=Forma de Pago
lblProveedor=Proveedor
lblPrecioUnitario=Precio Unitario
lblPrecioTotal=Precio Total
lblMoneda=Moneda
lblFechaQueSeRequiere=Fecha Necesaria
lblFechaEntragaEstimada=Fecha Vence
lblCostoTotalLinea = Costo Total
lblSNP=SNP
lblOtros=Otros
lblNotaOtros=Mano de Obra Insumos Comercio y Consumidor, Exhibiciones adicionales, brigadistas, PT Degustación o Muestras, Etc

lblOs=OS
lblNotaOs=Órdenes de Servicios relacionados con 

lblPop=POP
lblProductoMatrizPop=Producto Matriz POP
lblCodigoArticulo=Código Artículo
lblEvaluacionLegalizacion=Legalización
lblResultadoObjetivos=Resultados Objetivos
lblResultado=Resultado
lblComentarios=Comentarios
lblResultadosConcurso=Resultados Concurso
lblAnexoResultados=Anexo Resultados
lblPremio=$ Premio
lblPesoPorVariable=% Peso por Variable
lblTotal=Total

lblHistorialActivity=Historial del Activity
lblCargo=Cargo
lblFecha=Fecha
lblTiempo=Tiempo
lblModificaciones=Modificaciones
lblCampo=Campo
lblValorAnterior=Valor Anterior
lblNuevoValor=Nuevo Valor
lblAutorizo=Autorizó

lblTooltipAprobar=Aprobar
lblTooltipRechazar=Rechazar
lblTooltipSolicitar=Solicitar

maxFileSize=20
folderArchivos=Activity
folderArchivosPromociones=ActivityPromocion
msgArchivoNoEncontrado=No se encontró el archivo.

btnAgregarPromocion=Agregar Promoción
btnEditar=Editar
btnCerrar=Cerrar

msgImporteInvalido=El Importe del Activity debe ser mayor a cero
msjParticipacionPrecio=el % de participación de la promoción debe de ser 100
msjParticipacionObjetivos=El objetivo número {NumeroObjetivo} debe estar ligado a alguna promoción
msjFaltaObjetivo=debe agregar por lo menos un objetivo
msjFaltaDetalle=debe agregar por lo menos un detalle
msjConfiguracionListaPrecio=la configuración de la lista de precio está incompleta
msgFechaRequerida=Debe indicar la fecha de actividad
msgSeleccionarProducto=Debe seleccionar un producto que sea de tipo vendido
msgAnexoResultados=Debe anexar los resultados
msgMultiMarcas=Solo debe de seleccionar una marca.
msgGrupoMarcas=Selección  incorrecta de marcas.
msgEjecutadoPromocion=El ejecutado de la promoción no puede ser mayor al importe.
msgCerrar=El activity se cerrará ¿Desea Continuar?.
msgErrorRequisicion=No se pudo generar el archivo para la requisición, favor de contactar al administrador
msgErrorCerrarActivity = No se puede cerrar el activity {Codigo} hasta que la promoción este en estatus cerrado.

efdb-Activity-01=El nombre de la promoción ya existe
efdb-Activity-02=El monto del presupuesto de la marca ya fue agotado o no ha sido asignado.
efdb-TareaPendienteResponsable-01=No hay ningún responsable para el alta del proyecto, por favor contacte al Administrador
efdb-NotaCredito-01=El monto de la Nota de Crédito es menor a lo ya solicitado, por favor valide su información

lblRequisicion = Requisiciones
lblNumReq = Num. Requisición
lblNomProveedor = Nombre de proveedor
lblNumProveedor = Num. proveedor
lblUbicacion = Ubicación
lblSolicitadoPor = Solicitado por
lblUsuarioFinal = Usuario final
lblSubCuenta = Subcuenta
lblCentrodeCostos = Centro de costos
lblProyecto = Proyecto
lblEntidad = Empresa
lblReqMoneda = Moneda
lblReqFormatoLinea = Formato línea
lblReqGrupoLibro = Grupo libro
lblReqIdioma = Idioma
lblReqAlmacen = Almacén
lblReqArticulos = Artículos
lblReqArticulo = Artículo
lblReqUM = UM
lblReqCantidad = Cantidad
lblReqCostoUnitario = Costo unitario
lblReqObservaciones = Observaciones
lblReqRutaA = Ruta A
lblReqComprador = Comprador
lblReqTotal = Total
lblReqDescripcion = Descripción
lblGuardarComentario = Agregar Observación
lblSellOut = Sell Out/Otros
lblSellIn = Sell In
lblImpactoA = Impacto a
lblAgregaReq = Agregar Requisición

lblFolio=Folio
lblFechaSolicitud=Fecha Solicitud
lblActa = Acta
lblSolicitud = Solicitud
lblServicio = Servicio
lblServicioDescripcion = Este formato es una solicitud en la cual usted requiere y autoriza que se envíe y pague al Proveedor la ORDEN por los servicios descritos, previa entrega de Cotización y/o Contrato según aplique de acuerdo a las condiciones de crédito con que fue dado de alta.
lblCuenta=Cuenta
lblEntidadEmpresa = Entidad
lblCorreo = Correo
lblTelefono = Telefono
lblItems = Items
lblJustificacion = Justificación
lblArchivos = Archivos
lblSubtotal = SUBTOTAL
lblIVA =  IVA
lblRetenido = RETENCIONES
lblTotalAPagar = TOTAL A PAGAR
lblMonedaPago = MONEDA DE PAGO
lblFechaServicio = Fecha de servicio
lblFechaEntrega = Fecha de entrega
lblLugarEntrega = Lugar de entrega
lblCondicionesPago = Condiciones de pago
lblCantidadLetra = Cantidad con letra
lblValorUnitario = Valor Unitario
lblValorTotal = Valor Total
lblTipoProveedor = Tipo Proveedor
lblTooltipDescripcion = La descripción de la orden debe ser igual a la de la cotización con el mayor detalle posible para garantizar que se cumpla con lo solicitado al proveedor
efdb-Activity-03=La marca no tiene un gerente asignado. Favor de verificar
efdb-Activity-04=Error en la configuración de usuarios.
efdb-Activity-05=Error no se encontro un flujo de aprobación.
efdb-Activity-06=Error en la estructura de usuarios, existe mas de un director comercial configurado, favor de verificar.
efdb-Activity-07=No se encontro un usuario configurado para uno de los perfiles de aprobación de modificación, favor de verificar.
efdb-Activity-08=Error en la estructura de usuarios, existe mas de un gerente de medios configurado, favor de verificar.
efdb-Activity-09=No se encontro un usuario con el perfil gerente en el flujo de autorización, favor de verificar.
efdb-Activity-10=No se encontro un usuario con el perfil director de mercadeo en el flujo de autorización, favor de verificar.
efdb-Activity-11=No se encontro un usuario con el perfil gerente de marca en el flujo de autorización, favor de verificar.

lblTooltipExportar = Exportar
validExtensions=xlx,xlsx,pdf,doc,docx
lblHistorial = Histórico
lblFechaLiberacion=Fecha Liberación
lblFechaRequisicion = Fecha Requisición
lblTiempoEntrega = Tiempo Entrega
lblCostoMoneda= Costo Moneda
lblRequisicionQAD = Requisición QAD
lblAprobador = Aprobador
lblRequisitor= Requisitor
lblFechaLlegadaQuala = Fecha Llegada Quala
lblFechaLlegadaDistrito = Fecha Llegada Distrito
lblCotizacion = Cotización
btnDescargar=Descargar
lblTooltipDownload=Descargar Archivo
lblRequisiciones = Requisiciones
lblVerDetalle = Ver Detalle
lblMapaEstudio = Mapa de Estudio
lblConfirmar = Confirmar
lblBuscar = Buscar